0333333330
0222222220
0111111110
0111111110
0111111110
0000000000
0000000000
0000000000
0000000000
0000000000
